#########A##########
#         #        #
# ####### # ###### #
# #       #      # #
# # ####### #### # #
# # #           # # 
# # # ######### # #
# # # #   #B     # #
# # # #   ##### # #
#   # #         # #
## ## # ####### #
#                #
############# ####