#########A##########
#         #        #
# ####### # ###### #
# #   #   #      # #
# # # # ### ### # 
# # # #   #   # # #
# # # ### # # # # #
# # # #   #   # # #
# # # # ### ### # #
#   # #  #  B # #  #
## ####### ##### # #
#                # #
############# #### #